UMI = "countries/Michigan.txt"
UIL = "countries/Illinois.txt"
UNY = "countries/New York.txt"
UAL = "countries/Alabama.txt"
UCA = "countries/California.txt"
UTX = "countries/Texas.txt"
UIN = "countries/Indiana.txt"
UCI = "countries/Carolinas.txt"
UDK = "countries/Dakota.txt"
UMN = "countries/Minnesota.txt"
UEN = "countries/New England.txt"
UKY = "countries/Kentucky.txt"
UTN = "countries/Tennessee.txt"
UMS = "countries/Mississippi.txt"
UFL = "countries/Florida.txt"
UGO = "countries/Georgia.txt"
UVA = "countries/Virginia.txt"
UNE = "countries/Nebraska.txt"
UME = "countries/Missouri.txt"
UAR = "countries/Arkansas.txt"
ULA = "countries/Louisiana.txt"
UWI = "countries/Wisconsin.txt"
UOK = "countries/Oklahoma.txt"
UIA = "countries/Iowa.txt"
UKA = "countries/Kansas.txt"
UOH = "countries/Ohio.txt"
UPE = "countries/Pennsylvania.txt"
UML = "countries/Maryland.txt"
UNJ = "countries/New Jersey.txt"
UWA = "countries/Washington.txt"
UID = "countries/Idaho.txt"
UAZ = "countries/Arizona.txt"
UUT = "countries/Utah.txt"
UNV = "countries/Nevada.txt"
UOR = "countries/Oregon.txt"
UMO = "countries/Montana.txt"
UCO = "countries/Colorado.txt"
UMX = "countries/New Mexico.txt"
UWY = "countries/Wyoming.txt"